1111111111111111111111
1011111111000000000011
1000000000000000E00011
100000C00000000000P001
1111111111111111111111